1;1;2;NOTFREE;3;3;
2;2;3;NOTFREE;3;5;
3;3;2;NOTFREE;4;4;
4;4;3;NOTFREE;3;3;
5;5;4;NOTFREE;4;5;
6;6;2;NOTFREE;3;5;
7;7;3;NOTFREE;4;5;
8;8;3;NOTFREE;5;8;
9;9;4;NOTFREE;3;5;
10;10;3;NOTFREE;4;7;
