1;1;2;NOTFREE;3;3;
2;2;3;NOTFREE;3;5;
3;3;2;FREE;4;4;
4;4;3;FREE;3;3;
5;5;4;FREE;4;5;
6;6;2;FREE;3;5;
7;7;3;FREE;4;5;
8;8;3;FREE;5;8;
9;9;4;FREE;3;5;
10;10;3;FREE;4;7;
